0400000000000000000000000030000000005000000000001000000000
0400111111112222222000001030033333005000000000000044444001
0400000000000071000010001003000007105000000000000058000000
0411111122222220001000010031111111005000000000001011111111
0400000100000000000000001000000000005000000000000000000000
0400011100000010101010101010006004050000000001001010010000
0400000000000000000000000000006044000000000001000000101000
0400011111000010101010101010006040000111000001001010101000
0001010001000000000000000000006044000001000001000000100100
0401010001000010101010101010006004000001111101001010101000
0401010001000000000000000000x06004000000000101000000000100
0401110001001010110000000000006004444444000101001010001000
0400000000000010010011101100006000000001000101000000000100
0222222222222220010010000100001000100001000101001111001100
0000000000000000010010000100000003333333000100000001000100
0066660001111111110055555503330001000000001100000001110100
0060000001000000000000000003010002222222000000000000000000
0060000001000002323232323232000000000000000111111111110000
0060000001000000001000000003222222222221000000000001000000
0060000003333333333333300000000000000009111100000001000000
2222000000000000001000000012345614165432100100000000004444
0001000000222200001000000010001000000000000111111111001004
0001000000200100001000000000001000000000000000000001001000
0001000000200100000000000010001000000011111111110001001000
0001000000201100000000000010001000001010000000010001001000
0001000000201111111111100010001000001010001000010001000000
0000000000200000001000000010010000001010001000022222005550
0001000000200000001111111110001000001010000100000000000010
0002222222233333300000000000004444444444444400011111111110
0000090000000000000000000000000000000000000100018000000000
